# *DO NOT DIRECTLY EDIT THIS FILE, IT IS AUTOMATICALLY GENERATED AND IT IS BASED ON:*
# https://docs.google.com/spreadsheet/ccc?key=0AmQEO36liL4FdDJLWVNMaVV2UmRKSnpXU09MYkdGbEE
aboutDrawio=关于 draw.io
accessDenied=访问被拒绝
actualSize=实际尺寸
add=添加
addedFile=已添加 {1}
addImages=添加图像
addImageUrl=添加图像链接
addLayer=添加图层
addProperty=添加属性
address=地址
addToExistingDrawing=添加到当前的图形
addWaypoint=添加航点
adjustTo=适应
advanced=高级
align=对齐
alignment=对齐
allChangesLost=所有修改都不会被保存！
allPages=全部页
allProjects=全部项目
allSpaces=全部空间
allTags=全部标签
anchor=锚
android=Android
angle=角度
areYouSure=你确定吗？
ensureDataSaved=关闭前请确保你的数据已保存
allChangesSaved=所有更改已保存
allChangesSavedInDrive=所有更改已保存到硬盘
allowPopups=允许弹出框以避免此对话框
alreadyConnected=节点已连接
apply=应用
archiMate21=ArchiMate 2.1
arrange=排列
arrow=箭头
arrows=箭头
asNew=作为新建
atlas=现代
author=作者
authorizationRequired=需要授权
authorizeThisAppIn=在{1}里授权此应用
authorize=授权
authorizing=授权中
automatic=自动
autosave=自动保存
autosize=自动调整大小
attachments=附件
aws=AWS
aws3d=AWS 3D
azure=Azure
background=背景
backgroundColor=背景色
backgroundImage=背景图
basic=基本
blankDrawing=空图
blankDiagram=空白图表
block=块
blockquote=块引用
blog=博客
bold=粗体
bootstrap=Bootstrap
borderColor=边框颜色
borderWidth=边框宽度
bottom=底
bottomAlign=下对齐
bottomLeft=左下角
bottomRight=右下角
bpmn=BPMN
browser=浏览器
bulletedList=项目符号列表
business=Business
busy=正在处理中
cabinets=Cabinets
cancel=取消
center=居中
cannotLoad=载入失败，请稍候重试。
cannotLogin=登录失败，请稍候重试。
cannotOpenFile=不能打开文件
change=更改
changeOrientation=改变方向
changeUser=更改用户
changesNotSaved=更改尚未保存
chatJoined={1}已加入
chatLeft={1}已离开
chatWindowTitle=聊天
chooseAnOption=请选择
chromeApp=Chrome 应用
compressed=已压缩
commitMessage=提交日志
csv=CSV
draftFound='{1}' 的草稿已存在。加载到编辑器中或放弃操作以继续。
dragAndDropNotSupported=图片拖拽不支持。您要继续导入么？
dropboxCharsNotAllowed=系统不允许使用下列字符：\ / : ? * " |
check=检查
circle=圆形排列
cisco=Cisco
classic=经典
clearDefaultStyle=重置默认样式
clearWaypoints=重置航点
clipart=剪贴画
close=关闭
collaborator=合作者
collaborators=合作者
collapse=收起
collapseExpand=收起/展开
collapse-expand=收起/展开
collapsible=收展开关
comic=Comic
comment=评论
commentsNotes=备注
connect=连接
connecting=连接
connectWithDrive=连接谷歌硬盘
connection=连接
connectionArrows=连接箭头
connectionPoints=连接点
constrainProportions=约束比例
containsValidationErrors=包含验证错误
copiedToClipboard=复制到剪贴板
copy=复制
copyConnect=连接时复制
copyOf=副本 {1}
copyOfDrawing=复制图表
copyStyle=复制样式
create=创建
createNewDiagram=创建新图表
createRevision=创建修订版本
createShape=创建形状
crop=Crop
curved=曲线
custom=自定义
current=当前
cut=剪切
dashed=虚线
decideLater=稍后再说
default=默认
delete=删除
deleteColumn=删除列
deleteLibrary401=删除权限不足
deleteLibrary404=找不到所选库
deleteLibrary500=删除库操作时报错
deleteLibraryConfirm=您即将永久删除此库，确认删除？
deleteRow=删除行
description=描述
device=设备
diagram=图表
diagramContent=图表目录
diagramLocked=图表已加锁以避免进一步的数据丢失
diagramName=图表名
diagramIsPublic=图表已公开
diagramIsNotPublic=图表未公开
diamond=菱形
diamondThin=菱形（细）
didYouKnow=你知道吗......
direction=方向
discard=取消
discardChangesAndReconnect=取消更改并重新连接
googleDriveMissingClickHere=没有谷歌硬盘？
discardChanges=取消修改
disconnected=连接中断
distribute=等距分布
done=完成
dotted=点线
doubleClickOrientation=双击改变方向
doubleClickTooltip=双击插入文本
doubleClickChangeProperty=双击修改属性名称
download=下载
downloadAs=下载为
clickHereToSave=点击这里保存
draftDiscarded=废弃草稿
draftSaved=草稿已保存
dragElementsHere=在此拖拽元素
dragImagesHere=把图像拖到这里
dragUrlsHere=在此拖拽 URL
draw.io=draw.io
drawing=图表{1}
drawingEmpty=图表为空
drawingTooLarge=图表过大
drawioForWork=Draw.io for GSuite
dropbox=Dropbox
duplicate=复制
duplicateIt={1}已重复
divider=分隔线
east=向右
edit=编辑
editData=编辑数据
editDiagram=编辑图表
editGeometry=编辑几何图形
editImage=编辑图像
editImageUrl=编辑图像链接
editLink=编辑链接
editShape=编辑形状
editStyle=编辑样式
editText=编辑文本
editTooltip=编辑提示
glass=玻璃
googleImages=谷歌图片
imageSearch=图片搜索
eip=EIP
embed=嵌入
embedImages=嵌入图像
mainEmbedNotice=把这个粘贴至页面
electrical=Electrical
embedNotice=在页尾添加一次
enterGroup=进入局部
enterName=输入名
enterPropertyName=输入属性名
enterValue=输入值
entityRelation=实体关系
error=错误
errorDeletingFile=删除文件时报错
errorLoadingFile=加载文件错误
errorRenamingFile=文件更名错误
errorRenamingFileNotFound=文件更名错误， 文件未找到。
errorRenamingFileForbidden=文件更名错误， 没有足够的访问权限。
errorSavingDraft=保存草稿时报错
errorSavingFile=保存文件错误
errorSavingFileUnknown=授权谷歌服务时发生错误，请刷新页面后重试。
errorSavingFileForbidden=保存文件错误，没有足够的访问权限。
errorSavingFileNameConflict=无法保存图表。当前页已包含名为 '{1}' 的文件。
errorSavingFileNotFound=保存文件错误，文件未找到。
errorSavingFileSessionTimeout=您的会话已结束。请<a target='_blank' href='{1}'>{2}</a> 并返回当前TAB页，尝试重新保存。
errorSendingFeedback=发送反馈错误。
errorUpdatingPreview=更新预览报错。
exit=退出
exitGroup=离开局部
expand=展开
export=导出
exporting=导出
exportAs=导出为
exportOptionsDisabled=导出选项禁用
exportOptionsDisabledDetails=所有者已禁止阅览者下载、打印或复制该文件。
extras=附加功能
facebook=Facebook
failedToSaveTryReconnect=保存失败，正在尝试重新连接
featureRequest=增加功能请求
feedback=反馈
feedbackSent=反馈发送成功
floorplans=平面图
file=文件
fileChangedOverwrite=文件已修改。确认覆盖？
overwrite=覆盖
filename=文件名
fileExists=文件已存在
fileNearlyFullSeeFaq=File nearly full, please see FAQ
fileNotFound=没有此文件
repositoryNotFound=找不到存储库
fileNotFoundOrDenied=文件未找到。不存在或者你没有读权限。
fileNotLoaded=文件无法加载
fileNotSaved=文件无法保存
fileOpenLocation=你想如何打开这些文件？
fileWillBeSavedInAppFolder={1}将要保存在应用文件夹
fill=填充
fillColor=填充色
find=查找
fit=配合
fitContainer=调整容器大小
fitIntoContainer=适配容器
fitPage=整页
fitPageWidth=页宽
fitTo=适配
fitToSheetsAcross=sheet(s) across
fitToBy=by
fitToSheetsDown=sheet(s) down
fitTwoPages=两页
fitWindow=填满
flip=翻转
flipH=水平翻转
flipV=垂直翻转
flowchart=流程图
folder=文件夹
font=字体
fontColor=字体颜色
fontFamily=字体
fontSize=字体大小
forbidden=你没有该文件的访问权限
format=格式
formatPanel=格式面板
formatted=格式化
formattedText=格式化文本
formatPng=PNG
formatGif=GIF
formatJpg=JPEG
formatPdf=PDF
formatSvg=SVG
formatHtmlEmbedded=HTML
formatSvgEmbedded=SVG (with XML)
formatVsdx=VSDX
formatXmlPlain=XML (Plain)
formatXml=XML
forum=讨论组/帮助论坛
fromTemplate=从模板
fromTemplateUrl=从模板链接
fromText=从文本
fromUrl=来自 URL
fromThisPage=From this page
fullscreen=全屏
general=通用
github=GitHub
global=全局
googleDocs=谷歌文档
googleDrive=谷歌硬盘
googleGadget=谷歌插件
googlePlus=谷歌加
googleSites=谷歌协作平台
gradient=渐变
gradientColor=颜色
grid=网格
gridColor=网格颜色
gridSize=网格大小
group=组合
guides=参考线
hateApp=我讨厌draw.io
heading=标题
height=高
help=帮助
helpTranslate=帮助我们翻译此应用
hide=隐藏
hideIt=隐藏{1}
hidden=隐藏的
home=全域
horizontal=水平
horizontalFlow=水平流
horizontalTree=水平树
howTranslate=您的翻译水平如何？
html=HTML
htmlText=HTML文本
iframe=IFrame
ignore=忽略
image=图像
imageUrl=图像 URL
images=图像
imagePreviewError=该图片不能加载或预览，请检查下图片的 URL。
imageTooBig=图片太大了。
imgur=Imgur
import=导入
importFrom=从...导入
includeCopyOfMyDiagram=包含图表副本
increaseIndent=缩进
decreaseIndent=缩出
insert=插入
insertColumnBefore=左面插入列
insertColumnAfter=右面插入列
insertEllipse=插入椭圆
insertImage=插入图片
insertHorizontalRule=插入水平标尺
insertLink=插入链接
insertPage=插入页
insertRectangle=插入长方形
insertRowBefore=上面插入行
insertRowAfter=下面插入行
insertText=插入文本
inserting=正在插入
invalidFilename=图表名称不能包含如下特殊字符：\ / | : ; { } < > & + ? = "
invalidLicenseSeeThisPage=您的许可证无效，请查阅 <a target="_blank" href="https://support.draw.io/display/DFCS/Licensing+your+draw.io+plugin"></a>.
invalidName=无效名
invalidOrMissingFile=无效或丢失的文件
invalidPublicUrl=无效的公开 URL
isometric=等距
ios=iOS
italic=斜体
kennedy=经典
keyboardShortcuts=快捷键
layers=图层
landscape=横向
language=语言
leanMapping=Lean Mapping
lastChange={1}以前最新更改
lessThanAMinute=一分钟以内
licensingError=许可证错误
licenseHasExpired={1} 的许可证已于 {2} 过期。点击这里。
licenseWillExpire={1} 的许可证将于 {2} 过期。点击这里。
linkAccountRequired=If the diagram is not public a Google account is required to view the link.
linkText=链接文本
list=列表
minute=分钟
minutes=分钟
hours=小时
days=天
months=月
years=年
restartForChangeRequired=更改将在页面刷新后生效
laneColor=容器底色
lastModified=最近更新
layout=布局
left=左
leftAlign=左对齐
leftToRight=从左到右
libraryTooltip=在这里拖拽图形或点击 + 插入图形。双击图形可编辑。
lightbox=Lightbox
line=线型
lineend=线末端
lineheight=行高
linestart=线始端
linewidth=线宽
link=链接
links=链接
loading=加载中
lockUnlock=加锁/解锁
loggedOut=登出
logIn=登陆
loveApp=我爱draw.io
mathematicalTypesetting=数学排版
makeCopy=创建副本
manual=手册
middle=垂直居中
misc=Misc
mockups=Mockups
modificationDate=修改日期
modifiedBy=修改人
more=更多
moreResults=更多结果
moreShapes=更多图库
move=移动
moveToFolder=移动至文件夹
moving=正在移动
moveSelectionTo=将所选移动至{1}
name=Name
navigation=局部导航
networking=Networking
new=新建
newLibrary=新建库
nextPage=下一页
noAttachments=没有附件
noColor=无颜色
noFiles=无文件
noFileSelected=没有选择文件
noLibraries=没有库
noMoreResults=没有其他结果
none=无
noOtherViewers=无其他观众
noPlugins=无插件
noPreview=无预览
noResponse=服务器无响应
noResultsFor=没有找到'{1}'
noRevisions=无修订
noSearchResults=检索不到内容
noPageContentOrNotSaved=在本页面上找不到锚点，或尚未保存。
normal=正常
north=向上
notADiagramFile=不是图表文件
notALibraryFile=不是库文件
notAvailable=不可用
notAUtf8File=不是 UTF-8 编码的文件
notConnected=没有连接
note=备注
notUsingService=没有使用{1}?
numberedList=编号列表
offline=离线
ok=确定
oneDrive=OneDrive
online=线上
opacity=透明度
open=打开
openArrow=开放箭头
openExistingDiagram=打开现有图表
openFile=打开文件
openFrom=从...打开
openLibrary=打开库
openLibraryFrom=打开库
openLink=打开链接
openInNewWindow=在新窗口打开
openInThisWindow=在当前窗口中打开
openIt=打开{1}
openRecent=最近打开
openSupported=此软件支持的保存格式为.xml
options=选项
organic=有机排列
orthogonal=正交
otherViewer=其他观众
otherViewers=其他观众
outline=缩略图
oval=椭圆形
page=Page
pageContent=页面内容
pageNotFound=找不到页面
pageWithNumber=第 {1} 页
pages=页面
pageView=页面视图
pageSetup=页面设置
pageScale=页面比例
pan=平移
panTooltip=Space+Drag to pan
paperSize=页面尺寸
pattern=模式
paste=粘贴
pasteHere=粘贴在这里
pasteStyle=粘贴样式
perimeter=周长
permissionAnyone=任何人都可以编辑
permissionAuthor=只有我可以编辑
pickFolder=选择文件夹
pickLibraryDialogTitle=选择库
publicDiagramUrl=图表的公共外链
placeholders=占位符
plantUml=PlantUML
plugins=插件
pluginUrl=插件链接
pluginWarning=本页面请求载入以下插件：\n \n {1}\n \n 是否现在载入这些插件？\n \n 备注：确保在完全理解与此相关的安全问题的情况下再允许这些插件\n
plusTooltip=点击连接并克隆（Ctrl + 鼠标左键点击克隆，Shift + 鼠标左键点击连接）。拖拽连接（Ctrl + 鼠标点击拖拽克隆）。
portrait=竖向
position=位置
posterPrint=海报样式
preferences=喜好
preview=预览
previousPage=上一页
print=打印
printAllPages=打印全部页
procEng=Proc. Eng.
project=项目
priority=优先级
properties=属性
publish=发布
quickStart=快速入门视频
rack=Rack
radialTree=径向树
readOnly=只读
reconnecting=重新连接
recentlyUpdated=最近更新
recentlyViewed=最近查看
redirectToNewApp=文件是由draw.io pro所创建或修改的，正在重定向。
realtimeTimeout=似乎你在离线状态下做过更改。对不起，这些更改不能保存。
redo=重做
refresh=刷新
regularExpression=正则表达式
rememberMe=记住我
rememberThisSetting=记住设置
removeFormat=清除格式
removeFromGroup=从组中删除
removeIt=删除{1}
removeWaypoint=删除航点
rename=重命名
renamed=已重命名
renameIt=重命名{1}
renaming=正在重命名
replace=Replace
replaceIt={1}已经存在了。要替换它吗？
replaceExistingDrawing=替换当前图形
required=必填
reset=重置
resetView=Reset View
resize=调整大小
retina=Retina
responsive=响应
restore=重置
restoring=重置中...
retryingIn={1}秒后重试
retryingLoad=载入失败，正在重试...
retryingLogin=登录超时，正在重试...
reverse=Reverse
revision=修订
revisionHistory=修订历史
right=右
rightAlign=右对齐
rightToLeft=Right to left
rotate=旋转
rotateTooltip=点击并拖拽以旋转，点击并旋转90度。
rotation=旋转
rounded=圆角
save=保存
saveAndExit=保存并退出
saveAs=另存为
saveAsXmlFile=另存为 XML 文件？
saved=已保存
saveDiagramsTo=把图表存到
saveLibrary403=编辑此库的权限不足。
saveLibrary500=保存库时出错。
saving=保存中
scratchpad=便签
scrollbars=滚动条
search=搜索
searchShapes=检索形状
selectAll=选择全部
selectionOnly=仅限已选
selectEdges=选择连接
selectFile=选择文件
selectFolder=选择文件夹
selectFont=选择字体
selectNone=全不选
selectVertices=选择节点
sendMessage=发送
sendYourFeedbackToDrawIo=向 draw.io 发送反馈
serviceUnavailableOrBlocked=服务无法使用或已被屏蔽
sessionExpired=会话已过期，请刷新浏览器。
sessionTimeoutOnSave=会话已超时，您的谷歌硬盘连接已被中断。按OK键登录并保存。
setAsDefaultStyle=设置为默认样式
shadow=阴影
shape=形状
shapes=形状
share=共享
shareLink=共享编辑的链接
sharp=尖角
show=Show
showStartScreen=显示开始屏幕
sidebarTooltip=点击展开。将形状拖放到图中。按住 Alt 键并点击鼠标左键插入并连接图形。
signs=Signs
signOut=登出
simple=Simple
simpleArrow=Simple Arrow
size=大小
solid=Solid
sourceSpacing=始端间距
south=向下
software=软件
space=Space
spacing=间距
specialLink=特殊链接
standard=标准
starting=开始
straight=直线
strokeColor=线颜色
style=样式
subscript=下标
summary=概要
superscript=上标
support=支持
sysml=SysML
tags=Tags
table=表格
targetSpacing=末端间距
template=模板
templates=模板
text=文本
textAlignment=文本对齐
textOpacity=字体透明度
theme=主题
timeout=超时
title=标题
to=to
toBack=置于底层
toFront=置于顶层
tooltips=提示
top=顶
topAlign=上对齐
topLeft=左上角
topRight=右上角
transparent=透明
transparentBackground=透明背景
tryAgain=重试
tryOpeningViaThisPage=尝试通过此页打开。
turn=改变方向
type=类型
twitter=Twitter
uml=UML
underline=下划线
undo=取消操作
ungroup=取消组合
unsavedChanges=未保存的更改
unsavedChangesClickHereToSave=尚有修改内容未保存。点击这里保存。
untitled=无标题
untitledDiagram=未命名的表单
untitledLayer=未命名的层
untitledLibrary=未命名的库
unknownError=未知错误
updateFile=Update {1}
updatingDocument=更新文件。请稍候...
updatingPreview=正在更新预览，请稍候...
updatingSelection=正在更新所选内容，请稍候...
upload=上传
url=链接
userManual=用户手册
vertical=文字方向
verticalFlow=垂直流
verticalTree=垂直树
view=视图
viewUrl=链接到视图：{1}
voiceAssistant=语音助手 (beta)
warning=警告
waypoints=航点
west=向左
width=宽度
wiki=Wiki
wordWrap=自动换行
writingDirection=编写指南
yourEmailAddress=您的邮件地址
zoom=缩放
zoomIn=放大
zoomOut=缩小
basic=基本图
businessprocess=业务流程图
charts=图表
engineering=工程图
flowcharts=流程图
gmdl=Material Design
mindmaps=思维图
mockups=模型图
networkdiagrams=网络结构图
nothingIsSelected=未选择
other=其他
softwaredesign=软件设计图
venndiagrams=文氏图
webEmailOrOther=Web, email 或其他 Internet 地址
webLink=Web 链接
wireframes=线框图
